#################################################
##        ####                     B          ###
## ###### #### ############################## ###
## ###### #### #     ##############             #
## ######      # ################## ###### #### #
## ############# ################## ###### #    #
##                   ############## ###### # ####
######## ##### #####                       # ####
######## ##### ############################# ####
######## ##### ######### ####      ###     # ####
######## ##### ######### #### ######## ### # ####
######## #####           #### ######## ###   ####
######## ############### #### ######## ##########
##            ########## #### ######## ##########
## #############         #### ####     ##########
## ############# ############ #### ##############
##  ############                   ##############
### ############ ################################
### ##########          #########################
###A  ######## ##################################
#####          ##################################
#################################################
